# # # # # # # # # # # # # # # #\0
# S # #                   # F #\0
#   # #                   #   #\0
#   # #     # # # # #     #   #\0
#   # #     # # #   #     #   #\0
#   # #     # # #   #     #   #\0
#             # #   #     #   #\0
#             # #   #         #\0
#   # # # #   # #   #         #\0
#   #     #   # #   #     #   #\0
#   #     #         #     #   #\0
#   #         # #   #     #   #\0
#   #         # #   #     #   #\0
# # # # # # # # # # # # # # # #\0