################
#S##         #F#
# ##         # #
# ##  #####  # #
# ##  ### #  # #
# ##  ### #  # #
#      ## #  # #
#      ## #    #
# #### ## #    #
# #  # ## #  # #
# #  #    #  # #
# #    ## #  # #
# #    ## #  # #
################